17 17
9 9 9 9 9 9 9 9 9 9 9 9 9 9 9 9 9
9 1 1 1 1 1 1 1 0 1 1 1 1 1 1 1 9
9 1 1 0 1 1 1 1 0 1 1 0 3 0 1 1 9
9 1 1 3 1 5 1 1 0 1 1 1 1 1 1 1 9
9 1 1 0 1 1 1 1 0 1 1 1 1 1 1 1 9
9 12 12 0 12 12 12 12 0 12 12 12 12 12 12 12 9
9 12 12 0 12 12 12 12 0 12 12 12 12 12 12 12 9
9 12 12 12 12 12 12 12 0 12 12 12 12 12 12 12 9
9 12 12 12 12 12 0 0 2 0 0 12 12 12 12 12 9
9 13 13 13 13 13 13 13 13 13 13 13 0 13 13 13 9
9 13 13 13 13 13 13 13 13 13 13 13 0 5 13 13 9
9 13 13 0 0 0 4 0 13 13 13 13 0 13 13 13 9
9 13 13 13 13 13 13 13 13 13 13 13 0 13 13 13 9
9 14 14 14 5 14 14 14 14 14 14 14 3 14 14 14 9
9 14 14 14 14 14 14 14 14 14 14 14 0 14 14 14 9
9 14 14 14 14 14 14 14 14 14 14 14 14 14 14 14 9
9 9 9 9 9 9 9 9 9 9 9 9 9 9 9 9 9